00002225BBB90
00002227DDD80
00002227DDD80
00002226CCCA0
0001101011000
0110101101010
4440110110100
4440110100010
4441110001100
0000000000100